292,293,293,293,293,293,293,293,293,293,293,293
338,339,339,339,339,339,339,339,339,339,339,339
361,361,361,361,361,361,361,361,361,361,361,361
361,361,361,361,361,361,361,361,361,361,361,361
361,361,361,361,361,361,361,361,361,361,361,361
361,361,361,361,361,361,361,361,361,361,361,361
361,361,361,361,361,361,361,361,361,361,361,361
361,361,362,363,361,361,361,361,361,361,361,361
