0,0,0,0,0,0,0,0,0,0,0,0,0,0,0,0,0,0,0,0,0,0,0,0,0,0,0,0,0,0,0,0,0,0,0,0,0,0,0,0
0,0,0,0,0,9,9,9,9,9,9,9,2,2,2,2,2,2,0,0,0,0,0,0,0,0,0,0,0,0,0,2,2,2,2,2,2,0,0,0
0,0,0,0,0,9,0,0,0,0,0,9,2,2,2,2,2,2,2,2,2,2,2,2,2,2,2,2,2,2,2,2,2,2,2,2,2,0,0,0
0,0,0,0,6,9,0,0,0,0,0,9,6,6,6,6,6,6,6,6,6,6,6,6,6,6,6,6,2,2,2,2,2,2,2,2,2,2,0,0
0,0,0,0,6,9,0,0,0,0,0,9,9,9,9,6,6,6,6,6,6,6,6,6,6,6,6,6,2,2,2,2,2,2,2,2,2,2,0,0
0,0,0,0,6,9,0,0,0,9,9,9,9,8,9,6,6,6,6,6,6,6,6,6,6,6,6,6,2,2,2,5,5,5,5,5,2,2,2,0
0,0,0,0,6,0,0,0,0,9,9,9,0,7,0,6,6,6,6,6,6,6,6,6,6,6,6,6,2,2,2,5,4,5,5,5,2,2,2,0
0,0,0,0,6,0,0,0,0,9,9,9,0,7,0,6,6,6,6,6,6,6,6,6,6,6,6,6,2,2,2,5,3,5,5,5,2,2,2,0
0,0,0,2,6,0,0,0,0,0,0,0,6,6,6,6,6,6,6,6,6,6,6,5,5,5,6,6,2,2,2,0,3,0,2,0,2,2,2,0
0,0,2,2,6,0,0,0,0,0,6,0,6,6,6,6,6,6,6,6,6,6,6,4,4,4,6,6,2,2,2,2,2,2,2,2,2,2,2,0
0,0,2,2,6,0,0,0,0,6,6,6,6,6,6,6,6,6,6,6,6,0,0,4,4,4,0,0,2,2,2,2,2,2,2,2,2,2,2,0
0,2,2,2,6,0,0,0,0,6,6,6,6,6,6,6,6,6,6,6,6,0,0,4,4,4,0,0,2,2,2,2,2,2,2,2,2,2,2,0
0,2,4,4,6,0,0,0,0,6,6,6,6,6,6,6,6,6,6,6,6,0,0,4,4,4,0,0,2,2,2,2,2,2,2,2,2,2,2,0
0,2,4,4,6,0,0,0,0,0,0,0,0,0,0,0,0,0,0,6,6,0,0,4,4,4,0,0,2,2,2,2,2,2,0,0,0,0,0,0
0,2,0,2,6,6,0,0,0,0,0,0,0,0,0,0,0,0,0,6,6,0,0,4,4,4,0,0,2,2,2,2,2,2,0,0,0,0,0,0
0,2,2,2,6,6,0,0,0,0,0,0,0,0,0,0,0,0,0,6,6,0,0,3,3,3,0,0,2,2,2,2,2,2,0,0,0,0,0,0
0,2,2,2,6,6,6,6,6,6,6,6,6,6,6,6,0,0,0,6,6,2,2,2,2,2,2,2,2,2,2,2,2,2,2,2,2,2,2,0
0,0,0,0,0,0,0,0,0,0,0,0,0,0,0,0,0,0,0,0,0,2,2,2,2,2,2,2,2,2,2,2,2,2,2,2,2,2,2,0
0,0,0,0,0,0,0,0,0,0,0,0,0,0,0,0,0,0,0,0,0,2,2,2,2,2,2,2,2,2,0,0,0,0,0,0,0,2,2,0
0,0,0,0,0,0,0,0,0,0,0,0,0,0,0,0,0,0,0,0,0,2,2,2,2,2,2,2,2,2,0,0,0,0,0,0,0,2,2,0
0,0,0,0,0,0,0,0,0,0,0,0,0,0,0,0,0,2,0,0,0,2,2,2,2,2,2,2,2,2,0,0,0,0,0,0,0,2,2,0
0,0,0,0,2,2,2,2,2,2,2,2,2,2,2,2,0,2,0,2,2,2,2,2,2,2,2,2,2,2,0,0,0,2,2,2,2,2,2,0
0,0,0,0,2,2,2,2,2,2,2,2,2,2,2,2,0,2,0,2,2,2,2,2,2,2,2,2,2,2,0,0,0,2,2,2,2,2,2,0
0,0,0,0,2,2,2,2,2,2,2,2,2,2,2,2,0,2,2,2,2,2,2,2,2,2,2,2,2,2,0,0,0,2,2,2,2,2,2,0
0,0,0,0,0,2,2,2,2,2,2,2,2,2,2,2,0,0,0,0,0,0,0,0,0,2,2,0,0,0,0,0,0,2,2,2,2,2,2,0
0,0,0,0,0,2,2,2,2,2,2,2,2,2,2,2,0,0,0,0,0,0,0,0,0,2,2,0,0,0,0,0,0,2,2,2,2,2,2,0
0,0,0,4,4,4,2,2,2,2,0,0,0,0,0,0,0,0,0,0,0,0,0,0,0,2,2,0,0,0,0,0,0,2,2,2,2,2,2,0
0,0,0,4,4,4,2,2,2,2,0,0,0,0,0,0,0,0,0,2,2,2,2,2,2,2,2,2,2,2,2,2,2,2,2,2,2,2,2,0
0,2,2,4,4,4,2,2,2,2,0,0,0,0,0,0,0,0,0,2,2,2,2,2,2,2,2,2,2,2,2,2,2,2,2,2,2,2,2,0
0,2,2,0,0,0,2,2,2,2,0,0,0,2,2,2,2,2,2,2,2,2,2,2,2,2,2,2,2,2,2,2,2,2,2,2,2,2,2,0
0,2,2,2,2,2,2,2,2,2,0,0,0,2,2,2,2,2,2,2,2,2,2,2,2,2,2,2,2,2,2,2,2,2,2,2,2,2,2,0
0,2,2,2,2,2,2,2,2,2,0,0,0,2,2,2,2,2,2,2,2,2,2,2,2,2,2,2,2,2,2,2,2,2,2,4,4,4,2,0
0,0,0,0,0,0,0,2,2,0,0,0,0,2,2,2,2,2,2,2,2,2,2,2,2,2,2,2,2,2,2,2,2,2,2,4,4,4,2,0
0,0,0,0,0,0,0,2,2,0,0,0,0,2,2,2,2,2,2,2,2,2,2,2,2,2,2,2,2,2,2,2,2,2,2,4,4,4,2,0
0,0,0,0,0,0,0,2,2,0,0,0,0,2,2,2,2,2,2,2,2,2,2,2,2,2,2,2,2,2,2,2,2,2,2,0,2,0,2,0
0,2,2,2,2,2,2,2,2,2,2,2,2,2,2,2,2,2,2,2,2,2,2,2,2,2,2,2,2,4,4,4,2,2,2,2,2,2,2,0
0,0,2,2,2,2,2,2,2,2,2,2,2,2,2,2,2,2,2,2,2,2,2,2,2,2,2,2,2,4,4,4,2,2,2,2,2,2,0,0
0,0,0,0,0,0,2,2,2,2,2,2,2,2,2,2,2,2,2,2,2,2,2,2,2,2,2,2,2,0,0,0,2,2,2,2,2,2,0,0
0,0,0,0,0,0,0,0,0,2,2,2,2,2,2,2,2,2,2,2,2,2,2,2,2,2,2,2,2,2,2,2,2,2,2,2,0,0,0,0
0,0,0,0,0,0,0,0,0,0,0,0,0,0,0,0,0,0,0,0,0,0,0,0,0,0,0,0,0,0,0,0,0,0,0,0,0,0,0,0
