0,8,8,8,8,8,8,8,8,8,8,0,0
0,8,0,0,0,0,8,8,8,8,8,0,0
0,8,0,0,0,0,8,8,8,8,8,2,0
0,8,0,0,0,8,8,8,8,8,8,2,0
0,8,8,8,8,8,8,8,7,8,8,2,0
0,8,8,8,8,8,8,8,6,8,8,2,0
0,8,0,0,8,8,0,0,6,0,0,2,0
0,8,8,8,8,8,4,5,5,5,5,2,0
0,0,0,0,0,0,3,5,5,5,5,2,0
0,0,0,0,0,0,3,0,0,2,0,2,0
0,0,0,0,0,0,2,2,2,2,2,2,0
0,0,0,0,2,0,2,2,2,2,2,2,0
0,2,2,2,2,2,2,2,2,2,2,2,0
